0,0,0,0,0,0,0,0,0,0,0,0,0,0,0,0,0,0,0,0,0,0
0,0,0,0,0,0,0,0,0,0,0,0,0,0,0,0,0,0,13,14,15,0
0,0,0,0,0,0,7,7,0,0,0,0,7,7,7,7,7,7,7,7,7,7
0,0,0,0,0,6,0,0,0,0,0,0,0,0,0,0,0,0,0,0,0,0
0,7,7,7,7,7,0,0,0,0,0,0,0,0,0,0,0,0,0,0,0,0
0,0,0,0,0,0,0,0,6,0,0,4,0,0,0,0,0,0,0,0,0,0
0,0,0,0,0,0,0,0,7,11,11,7,0,0,0,0,0,0,0,0,0,0
0,0,0,0,4,4,0,0,0,0,0,0,6,0,0,5,0,0,0,0,0,0
0,7,10,10,7,7,0,0,0,0,0,0,7,9,9,7,0,0,0,0,0,0
1,2,3,0,0,0,0,0,0,0,0,5,5,0,0,0,0,0,0,0,0,0
7,7,7,7,7,7,7,7,12,12,7,7,7,7,7,7,7,7,7,7,7,7